11111111111111111111111111111
1000001C000001111110000000001
10111011111101111110111111111
10110011000000010000001C00001
10000000001111110110101111101
10111C01111010000010100000101
10100001C00010111110111110001
10110001111000001000000011111
10111100111011101011111010001
1000010001000E1C1000001000101
11110111111111111111111111101
10010000000000000000010000001
11011101110100010111110111011
11000101110111110111110111111
10010111100000110100C00100001
10111100C01110110101111101111
10000111111010100000000000001
111100C1111010111111111111101
1001P100000000000C00000000001
11111111111111111111111111111